111111111111111111111111
111111111111111111111111
111111111111111111111111
11111111111_______111111
11111111111_______111111
11111111111_______111111
11111111111_______111111
11111111111_______111111
11111111111_______111111
11111111111_______111111
11111111111_______111111
1111______________111111
1111______________111111
1111______________111111
1111______________111111
111111111111111111111111
111111111111111111111111
111111111111111111111111
111111111111111111111111
111111111111111111111111
111111111111111111111111
111111111111111111111111
111111111111111111111111
